2 2 2 2 2 2 2 2 2 2 2 2 2 2 2 2 2 2 2 2 2 2 2 2 2 2 2 2 2 2 2 2 2 2 2 2 2 2 2 2 2 2 2 2 2 2 2 2 2 2
2 2 2 2 2 2 2 2 2 2 2 2 2 2 2 2 2 2 2 2 2 2 2 2 2 2 2 2 2 2 2 2 2 2 2 2 2 2 2 2 2 2 2 2 2 2 2 2 2 2
2 2 2 2 2 2 2 2 2 2 2 2 2 2 2 2 2 2 2 2 2 2 2 2 2 2 2 2 2 2 2 2 2 2 2 2 2 2 2 2 2 2 2 2 2 2 2 2 2 2
2 2 2 2 2 2 2 2 2 2 2 2 2 2 2 2 2 2 2 2 2 2 2 2 2 2 2 2 2 2 2 2 2 2 2 2 2 2 2 2 2 2 2 2 2 2 2 2 2 2
2 2 2 2 2 2 2 2 2 2 2 2 2 2 2 2 2 2 2 2 2 2 2 2 2 2 2 2 2 2 2 2 2 2 2 2 2 2 2 2 2 2 2 2 2 2 2 2 2 2
2 2 2 2 2 2 2 2 2 2 2 2 2 2 2 2 2 2 2 2 2 2 2 2 2 2 2 2 2 2 2 2 2 2 2 2 2 2 2 2 2 2 2 2 2 2 2 2 2 2
2 2 2 2 2 2 2 2 1 1 1 1 1 1 1 1 2 2 2 2 2 2 2 2 2 2 2 2 2 2 2 2 2 2 1 1 1 1 1 2 2 2 2 2 2 2 2 2 2 2
2 2 2 2 2 2 2 1 1 1 1 1 1 1 1 1 1 2 2 2 1 1 1 1 2 2 2 2 2 2 2 2 1 1 1 1 1 1 1 2 2 2 2 2 2 2 2 2 2 2
2 2 2 2 2 2 2 1 1 1 0 0 0 1 1 1 1 1 1 1 1 1 1 1 1 1 1 2 2 2 1 1 1 1 1 1 0 1 1 2 2 2 2 2 2 2 2 2 2 2
2 2 2 2 2 2 2 2 1 1 0 1 0 0 1 0 1 1 1 1 1 0 1 1 0 1 1 2 2 1 1 1 1 1 1 0 0 1 1 1 2 2 2 2 2 2 2 2 2 2
2 2 2 2 2 2 2 2 1 1 1 0 0 0 0 0 0 1 1 0 0 0 0 1 0 0 1 1 1 1 0 0 1 1 0 1 0 0 1 1 1 2 2 2 2 2 2 2 2 2
2 2 2 2 2 2 2 2 2 1 1 1 0 0 3 3 0 0 0 0 0 3 0 0 0 0 0 1 1 0 0 1 0 0 0 0 1 0 1 1 1 1 1 2 2 2 2 2 2 2
2 2 2 2 2 2 2 2 2 1 1 1 0 0 3 3 3 0 0 0 3 3 0 0 0 0 0 0 1 1 0 0 0 0 0 0 0 0 1 1 1 1 1 2 2 2 2 2 2 2
2 2 2 2 2 2 2 2 2 1 1 0 1 0 0 3 3 0 0 0 3 3 0 0 0 0 0 0 1 0 0 0 0 0 0 3 3 0 0 0 1 1 1 2 2 2 2 2 2 2
2 2 2 2 2 2 2 2 2 1 1 1 1 1 0 0 0 0 0 0 0 0 0 2 2 2 0 0 0 0 0 3 3 0 0 3 3 0 0 0 1 1 1 2 2 2 2 2 2 2
2 2 2 2 2 2 2 2 2 1 1 1 0 1 0 0 0 2 2 0 0 0 0 0 0 2 0 0 0 0 3 3 3 0 0 0 3 0 0 0 1 1 1 2 2 2 2 2 2 2
2 2 2 2 2 2 2 2 2 1 1 0 0 0 0 0 0 0 2 2 0 0 0 0 0 2 0 0 0 0 0 0 0 0 0 0 0 0 0 1 0 1 1 2 2 2 2 2 2 2
2 2 2 2 2 2 2 2 2 1 1 1 0 0 3 3 0 0 0 2 0 2 2 0 0 2 2 2 0 0 0 0 2 2 0 0 0 0 0 1 1 1 1 2 2 2 2 2 2 2
2 2 2 2 2 2 2 2 2 1 1 1 0 3 3 0 0 0 0 2 2 2 2 0 0 0 0 2 2 2 0 0 2 0 0 0 0 0 0 1 1 1 1 2 2 2 2 2 2 2
2 2 2 2 2 2 2 2 1 1 1 0 0 0 0 0 0 0 2 2 2 2 0 0 0 0 0 0 0 2 2 2 2 0 0 0 0 0 0 0 1 1 2 2 2 2 2 2 2 2
2 2 2 2 2 2 2 2 1 1 1 0 0 0 0 0 0 2 2 2 2 0 0 3 3 3 3 0 0 0 2 2 0 0 0 0 3 0 0 1 1 1 2 2 2 2 2 2 2 2
2 2 2 2 2 2 2 2 1 1 0 0 2 0 0 0 2 2 2 0 0 0 3 0 0 0 0 3 0 0 0 2 0 0 0 3 3 0 1 1 0 1 2 2 2 2 2 2 2 2
2 2 2 2 2 2 2 2 1 1 1 0 2 2 2 0 2 2 0 0 0 3 0 0 0 0 0 0 3 0 0 2 0 0 0 3 3 0 0 1 0 1 1 2 2 2 2 2 2 2
2 2 2 2 2 2 2 2 1 1 1 0 0 2 2 2 2 2 0 0 3 0 0 0 0 0 0 0 0 3 0 2 2 0 0 0 0 0 0 1 1 0 1 1 2 2 2 2 2 2
2 2 2 2 2 2 2 2 2 1 1 0 0 0 0 2 2 2 0 0 3 0 0 0 0 1 0 0 0 3 0 0 2 0 0 0 0 0 0 0 1 0 1 1 2 2 2 2 2 2
2 2 2 2 2 2 2 2 1 1 1 0 0 0 0 0 2 0 0 0 3 0 0 0 1 0 0 0 0 3 0 0 0 0 0 0 0 0 0 0 1 1 1 2 2 2 2 2 2 2
2 2 2 2 2 2 2 2 1 1 0 0 0 3 0 0 0 0 0 0 3 0 0 0 0 0 0 0 0 3 0 0 0 0 0 0 0 0 0 1 1 0 1 2 2 2 2 2 2 2
2 2 2 2 2 2 2 2 1 1 1 0 0 3 0 0 2 2 0 0 0 3 0 0 0 0 0 0 3 0 0 0 2 0 0 0 0 0 0 1 1 1 1 2 2 2 2 2 2 2
2 2 2 2 2 2 2 2 2 1 1 1 0 0 0 0 2 2 0 0 0 0 3 0 0 0 0 3 0 0 0 2 2 0 0 0 3 0 0 1 1 1 2 2 2 2 2 2 2 2
0 0 0 62 63 63 63 63 64 1 1 0 0 0 0 0 2 2 2 0 0 0 0 3 0 0 3 0 0 0 0 2 0 0 0 3 3 0 0 0 1 1 1 2 2 2 2 2 2 2
0 0 0 65 66 66 66 66 67 1 1 1 0 0 2 2 2 0 2 2 0 0 0 0 0 0 0 0 0 0 2 2 0 0 0 0 3 0 0 1 0 0 1 2 2 2 2 2 2 2
0 0 0 68 69 69 69 69 70 1 1 0 0 0 2 0 0 0 0 2 2 0 0 0 0 0 0 0 0 2 2 2 2 0 0 0 0 0 0 0 0 1 1 2 2 2 2 2 2 2
2 2 2 2 2 2 2 2 2 1 1 0 0 0 2 0 0 3 0 2 2 2 0 0 0 2 0 2 2 2 0 0 2 0 0 0 0 0 0 1 0 1 2 2 2 2 2 2 2 2
2 2 2 2 2 2 2 2 2 1 1 0 0 0 0 0 0 0 0 2 0 0 0 0 0 2 2 2 0 0 0 0 2 2 0 0 0 0 0 1 1 1 1 2 2 2 2 2 2 2
2 2 2 2 2 2 2 2 1 1 1 0 0 3 3 0 0 0 0 2 0 0 0 0 0 0 0 0 0 0 0 0 0 2 0 0 3 0 0 0 1 1 1 2 2 2 2 2 2 2
2 2 2 2 2 2 2 2 1 1 1 0 3 3 0 0 0 0 0 0 0 0 0 3 3 0 0 0 0 0 3 3 3 0 0 3 3 0 0 0 0 1 1 2 2 2 2 2 2 2
2 2 2 2 2 2 2 2 1 1 0 0 0 0 0 1 1 0 0 0 0 3 3 3 0 0 0 0 0 0 0 0 0 0 0 3 0 0 0 0 1 1 1 2 2 2 2 2 2 2
2 2 2 2 2 2 2 2 1 1 0 0 0 1 1 1 1 1 1 0 0 0 0 0 0 0 0 0 0 1 0 0 0 0 0 0 0 0 0 0 0 1 1 2 2 2 2 2 2 2
2 2 2 2 2 2 2 2 1 1 0 0 1 1 1 1 2 1 1 0 0 0 0 0 0 1 1 0 0 1 1 0 0 0 0 0 0 0 1 1 1 1 1 2 2 2 2 2 2 2
2 2 2 2 2 2 2 2 1 1 0 1 1 1 1 2 2 1 1 0 0 0 0 0 1 1 1 1 0 1 1 1 1 0 1 1 0 1 1 1 1 1 1 2 2 2 2 2 2 2
2 2 2 2 2 2 2 2 1 1 1 1 1 1 2 2 2 1 1 1 0 0 0 1 1 1 1 1 1 1 1 1 1 1 1 1 1 1 1 1 1 1 2 2 2 2 2 2 2 2
2 2 2 2 2 2 2 2 1 1 1 1 2 2 2 2 2 2 1 1 1 1 1 1 1 1 2 2 2 2 2 2 2 1 1 1 1 1 1 2 2 2 2 2 2 2 2 2 2 2
2 2 2 2 2 2 2 2 2 71 72 73 2 2 2 2 2 2 2 1 1 1 1 1 1 2 2 2 2 2 2 2 2 2 2 1 1 1 1 2 2 2 2 2 2 2 2 2 2 2
2 2 2 2 2 2 2 2 2 74 75 76 2 2 2 2 2 2 2 2 2 2 2 1 2 2 2 2 2 2 2 2 2 2 2 2 1 1 1 2 2 2 2 2 2 2 2 2 2 2
2 2 2 2 2 2 2 2 2 77 78 79 2 2 2 2 2 2 2 2 2 2 2 2 2 2 2 2 2 2 2 2 2 2 2 2 2 2 2 2 2 2 2 2 2 2 2 2 2 2
2 2 2 2 2 2 2 2 2 0 0 0 2 2 2 2 2 2 2 2 2 2 2 2 2 2 2 2 2 2 2 2 2 2 2 2 2 2 2 2 2 2 2 2 2 2 2 2 2 2
2 2 2 2 2 2 2 2 2 0 0 0 2 2 2 2 2 2 2 2 2 2 2 2 2 2 2 2 2 2 2 2 2 2 2 2 2 2 2 2 2 2 2 2 2 2 2 2 2 2
2 2 2 2 2 2 2 2 2 2 2 2 2 2 2 2 2 2 2 2 2 2 2 2 2 2 2 2 2 2 2 2 2 2 2 2 2 2 2 2 2 2 2 2 2 2 2 2 2 2
2 2 2 2 2 2 2 2 2 2 2 2 2 2 2 2 2 2 2 2 2 2 2 2 2 2 2 2 2 2 2 2 2 2 2 2 2 2 2 2 2 2 2 2 2 2 2 2 2 2
2 2 2 2 2 2 2 2 2 2 2 2 2 2 2 2 2 2 2 2 2 2 2 2 2 2 2 2 2 2 2 2 2 2 2 2 2 2 2 2 2 2 2 2 2 2 2 2 2 2
