13 11 11 11 11 11 11 11 11 14
9 8 8 8 8 8 8 8 8 7
9 8 8 8 8 8 8 8 8 7
9 8 15 8 8 8 8 8 8 7
9 8 8 8 8 8 15 8 8 7
9 8 8 8 8 8 8 8 8 7
9 8 8 8 8 8 8 18 8 7
9 8 8 18 8 8 8 8 8 7
9 8 8 8 8 8 8 8 8 7
16 5 5 5 5 5 5 5 5 17
