  21 21 21 21 21 21 21 21 21 21 21 21 21 21 21 21 21 21 21 21 21 21 21 21 21 21 21 21 21 21 21 21 21 21 21 21 21 21 21 21 21 21 21 21 21 21 21 21 21 21 21 21 21 21 21 21 21 21 21 21 21 21 21 21 21 21 21 21 21 21 21 21 21 21 21 21 21 21 21 21
  21 21 21 21 21 21 21 21 21 21 21 21 21 21 21 21 21 21 21 21 21 21 31 21 21 21 21 21 21 21 21 21 21 21 21 21 21 21 21 28 28 21 21 21 21 21 21 21 21 21 21 21 28 21 21 21 21 21 21 21 31 21 21 21 21 21 21 21 21 21 21 21 21 47 48 48 49 21 21 21
  21 21 21 21 21 21 21 21 21 21 21 21 21 21 21 28 28 21 21 21 21 21 31 21 21 21 21 21 21 47 48 49 21 21 21 21 21 28 21 28 28 21 21 21 21 21 21 21 21 28 21 21 21 21 21 21 21 21 21 21 21 21 21 21 21 21 21 21 21 21 21 21 21 50 51 51 52 21 21 21
  21 21 21 21 28 28 21 21 21 21 21 21 21 21 28 28 21 21 21 21 21 21 21 21 21 21 21 21 21 50 43 52 21 21 21 21 21 21 21 21 21 21 21 21 21 21 21 21 21 28 28 28 21 21 21 21 21 21 21 21 21 21 21 21 21 21 21 21 21 21 21 21 21 50 46 51 52 21 21 21
  21 21 21 28 28 28 21 21 21 21 21 21 21 21 21 21 21 21 21 21 21 21 21 21 21 21 21 21 31 53 54 55 21 21 21 21 21 21 21 21 21 21 21 21 21 21 21 21 21 21 21 28 21 21 21 21 21 21 21 21 21 21 21 21 21 21 21 21 21 21 21 21 21 53 54 54 55 21 21 21
  21 21 21 21 21 21 21 21 21 21 21 21 21 21 21 21 21 21 21 21 21 21 21 21 21 21 21 21 21 21 21 21 21 21 21 21 21 21 21 21 21 21 21 21 21 21 21 21 21 21 21 21 21 21 21 21 21 21 21 21 21 21 21 21 28 28 28 21 21 21 21 21 21 31 31 31 21 21 21 21
  21 21 21 21 21 21 21 21 21 21 21 21 21 21 21 21 21 21 21 21 21 21 21 21 21 21 21 21 21 21 21 21 21 21 21 21 21 21 21 47 48 48 48 48 49 21 21 21 21 21 21 21 21 21 21 21 21 21 21 21 21 21 21 21 28 28 28 28 28 21 21 21 21 21 21 21 21 21 21 21
  21 21 21 21 21 21 21 21 21 21 21 21 21 21 21 21 47 48 48 48 48 48 49 21 21 21 21 21 21 21 21 21 21 21 21 47 48 48 48 59 43 51 51 51 52 21 21 21 21 21 21 21 21 21 21 21 21 31 31 31 21 21 21 21 21 28 28 28 28 21 21 21 21 21 21 21 21 21 21 21
  21 21 21 21 21 21 21 21 21 21 21 21 21 21 21 21 50 46 51 51 51 51 52 21 21 21 21 21 21 21 21 21 21 21 47 59 46 51 51 51 51 51 51 51 58 49 21 21 21 21 21 21 21 21 21 21 31 47 48 48 49 21 21 21 21 21 21 21 21 21 21 21 21 21 21 21 21 21 21 21
  21 21 21 21 21 21 21 21 21 21 21 21 21 21 47 48 59 51 56 54 57 51 58 48 48 49 21 21 21 21 21 21 21 21 50 51 51 51 51 51 51 51 51 51 51 58 48 49 21 21 21 21 21 21 21 21 47 59 43 51 52 21 21 21 21 21 21 21 21 21 21 21 21 21 21 21 21 21 21 21
  21 21 21 47 49 21 21 21 21 21 21 21 21 21 50 43 51 51 52 21 50 51 51 51 51 51 60 61 61 61 61 61 61 62 51 51 51 51 51 51 56 54 57 51 43 51 51 52 21 21 21 21 21 21 21 21 50 51 51 56 55 21 21 21 21 21 21 21 21 21 21 21 21 21 21 21 21 21 21 21
  21 21 47 59 52 21 21 21 21 21 21 21 21 21 50 51 51 51 58 48 59 51 51 51 51 51 63 64 64 64 64 64 64 65 51 51 51 51 51 51 52 21 50 51 51 51 51 52 21 21 21 21 21 21 21 21 53 54 54 55 21 21 21 21 21 21 21 21 21 21 21 21 21 21 21 21 21 21 21 21
  21 21 50 46 52 31 21 21 21 21 21 47 48 48 59 51 51 51 51 51 51 51 51 51 51 51 66 67 67 67 67 67 67 68 51 51 51 51 46 51 58 48 59 51 51 51 51 58 48 48 49 21 21 21 21 21 21 21 21 21 21 21 21 47 48 48 48 49 21 21 21 21 21 21 21 21 21 21 21 21
  21 21 50 56 55 31 21 21 21 21 47 59 51 51 51 51 51 51 51 51 51 43 56 54 54 55 21 21 21 21 21 21 21 21 50 51 51 51 51 51 51 51 51 51 51 51 51 51 51 46 52 21 21 21 21 21 21 21 47 48 48 48 48 59 46 51 51 58 48 49 21 21 21 21 21 21 21 21 21 21
  21 21 53 55 31 21 21 21 21 47 59 51 51 51 51 51 51 51 56 54 54 54 55 21 21 21 21 21 21 21 21 21 21 47 59 51 51 51 51 51 51 51 51 51 51 51 51 51 51 51 52 21 21 21 21 21 21 21 50 43 51 51 51 51 51 51 51 51 46 58 49 21 21 21 28 28 21 21 21 21
  21 21 21 21 21 21 21 21 21 50 46 51 51 51 51 51 56 54 55 21 21 21 21 21 21 21 21 21 21 21 21 21 47 59 43 51 51 51 51 51 51 51 51 51 46 51 51 51 51 56 55 21 21 21 21 21 21 21 50 51 51 51 51 51 51 51 56 57 51 51 52 21 21 21 28 28 21 21 21 21
  21 21 21 21 21 21 21 21 21 50 51 51 51 51 51 56 55 21 21 21 21 21 21 21 21 21 21 21 21 21 21 21 50 51 51 51 51 51 51 51 51 51 51 51 51 51 56 57 51 52 21 21 21 21 21 21 21 47 59 51 51 51 51 51 51 51 52 50 51 51 52 21 21 21 28 21 21 21 21 21
  21 21 21 21 21 21 21 21 21 50 51 51 51 51 51 52 21 21 21 21 21 21 21 21 21 21 21 21 21 21 21 21 50 51 51 56 54 57 51 51 51 51 51 51 51 56 55 50 51 52 21 21 21 21 21 21 47 59 51 51 51 51 51 51 51 51 58 59 51 51 52 21 21 21 21 21 21 21 21 21
  21 21 21 21 21 21 21 21 21 50 51 51 51 51 46 52 21 21 21 21 21 47 48 48 49 21 21 21 21 21 21 21 50 51 51 58 49 50 46 51 51 51 51 51 51 52 31 50 51 52 21 21 21 21 21 21 50 51 51 51 51 46 51 51 51 51 51 51 51 46 52 21 21 21 21 21 21 21 21 21
  21 21 21 21 21 21 21 21 21 50 51 51 51 51 56 55 21 21 21 21 47 59 51 46 58 49 21 21 21 21 21 21 50 51 46 51 52 50 51 51 51 51 51 51 51 58 48 59 51 51 60 61 61 61 61 62 51 51 51 51 51 51 51 51 51 51 51 56 54 54 55 21 21 21 21 31 31 21 21 21
  21 21 21 21 21 21 21 21 21 50 51 51 51 51 52 21 21 21 21 47 59 51 51 51 51 52 21 21 21 21 21 21 50 51 51 51 58 59 51 51 51 51 51 43 51 51 51 51 51 51 63 64 64 64 64 65 51 51 51 51 51 51 51 51 51 51 51 52 21 21 21 21 21 21 31 47 48 49 21 21
  21 21 21 21 21 21 21 21 21 53 51 51 51 54 55 21 21 21 21 50 51 51 43 51 51 52 21 21 21 21 21 21 53 57 51 51 51 51 51 51 51 51 51 56 54 57 51 51 51 51 66 67 67 67 67 68 51 51 51 51 51 56 54 51 51 51 54 55 21 21 21 21 21 21 47 59 51 52 21 21
  21 21 28 21 21 21 21 21 21 21 69 70 71 21 21 21 21 21 21 53 57 51 51 51 56 55 21 21 21 21 21 21 21 53 54 54 57 51 51 51 51 51 51 52 21 50 43 56 54 55 21 21 21 21 21 21 50 43 51 56 54 55 21 69 70 71 21 21 21 21 21 21 21 21 50 46 51 52 21 21
  21 21 28 28 21 21 21 21 21 21 72 73 74 21 21 21 21 21 21 21 53 54 54 54 55 31 21 21 21 21 21 21 21 21 21 21 50 51 51 46 51 56 54 55 21 53 54 55 21 21 21 21 21 21 21 21 53 54 54 55 21 21 21 72 73 74 21 21 21 21 28 21 21 21 50 51 56 55 21 21
  21 21 28 21 21 21 21 21 21 21 72 73 74 21 21 21 21 21 21 21 21 31 31 31 31 21 21 21 21 21 21 21 21 21 21 21 53 54 57 51 56 55 21 21 21 21 21 21 21 21 21 21 21 21 21 21 21 21 21 21 21 21 21 72 73 74 21 21 21 21 28 21 21 21 53 54 55 21 21 21
  21 21 21 21 21 21 21 21 21 21 72 73 74 21 21 21 21 21 21 21 21 21 21 21 21 21 21 21 21 21 21 21 21 21 21 21 21 21 53 54 55 21 21 21 21 21 21 21 21 21 21 21 21 31 31 21 21 21 21 21 21 21 21 72 73 74 21 21 21 21 28 28 21 21 21 21 21 21 21 21
  21 21 21 21 21 21 21 21 21 21 72 73 74 21 21 21 21 21 21 21 21 21 21 21 21 21 21 21 21 21 21 21 21 21 21 21 21 21 21 21 21 21 21 21 21 21 21 21 21 21 21 21 21 21 31 21 21 21 21 21 21 21 21 75 76 77 21 21 21 21 21 28 21 21 21 21 21 21 21 21
  21 21 21 21 21 21 21 21 21 21 75 76 77 21 21 21 21 21 21 21 21 21 21 21 21 21 21 21 21 21 21 21 21 21 21 21 21 21 21 21 21 21 21 21 21 21 21 21 31 21 21 21 21 21 31 31 21 21 21 21 21 21 26  6  6  6 27 21 21 21 21 21 21 21 21 21 21 21 21 21
  21 21 21 21 21 21 21 21 21 26  6  6  6 27 21 21 21 21 21 21 21 21 21 21 21 21 21 21 21 21 21 21 21 21 21 21 21 21 21 21 21 21 21 21 21 21 21 21 21 21 21 21 21 21 21 21 21 21 21 21 21 26 25  6 16  6 23 24 27 21 21 21 21 21 21 21 21 21 21 21
  21 21 21 21 21 21 21 21 21 22  6  6  6 23 27 21 21 21 21 21 21 21 21 21 21 21 21 21 21 21 21 21 21 21 21 21 21 21 21 21 21 21 21 21 21 21 21 21 21 21 21 21 21 21 21 21 21 21 21 21 26 25  6  6  6  6  6 17 30 21 21 21 21 21 21 21 21 21 21 21
  21 21 21 21 21 21 21 21 21 22  6 16  6  6 23 24 27 21 21 21 21 21 21 21 21 21 21 21 21 21 21 21 21 21 21 26 24 24 24 24 24 24 24 24 27 21 21 21 21 21 21 21 21 21 21 21 21 26 24 24 25  1  1  6  6  6  6 20 21 21 21 21 21 21 21 21 21 21 21 21
  21 21 21 21 21 21 21 21 21 29 19  6  6  6  6  6 23 27 21 21 21 21 21 21 21 31 21 21 21 21 21 21 21 26 24 25  6  6  1 13  13 1  6  6 23 24 27 21 21 21 21 21 21 21 21 21 21 22  6  6  6  1  6  6  1  6  6 20 21 21 21 21 21 21 21 21 21 21 21 21
  21 21 21 21 21 21 21 21 21 21 22  6  6  6 16  6  6 20 21 21 21 21 21 21 21 31 21 21 21 21 21 21 26 25  6  1  1  6  6  6  6  6 16  1  6  6 23 27 21 21 21 21 21 21 21 21 21 22 13  6  6  6  1 17 18 19  6 23 27 21 21 21 21 21 21 21 21 21 21 21
  21 21 26 24 27 21 21 21 21 21 22  1  6  6  6  6  6 23 24 24 27 21 21 21 21 21 21 21 21 21 21 26 25  6  6  6  6  6  6  6 16  6  6  6  1  6  6 23 27 21 21 21 21 21 21 21 21 29 18 18 19  6 17 30 21 22  6 16 23 27 21 21 21 21 21 21 21 21 21 21
  21 26 25  1 20 21 21 21 21 21 22  6  1 32 33 34  1  1 13  6 20 21 21 21 21 21 21 21 21 21 21 22  6  6  6 16  6  1  1  1  1  1  1  6  6  6  6  6 20 21 21 21 21 31 21 21 21 21 21 21 22  6 20 21 21 22  1  6  6 20 21 21 21 21 21 21 21 21 21 21
  21 22 11 12 20 21 21 21 21 21 22  1  1 35 36 37  1  6  1  6 20 21 21 21 21 21 21 21 21 21 26 25  1  6  6  6  1  1  1  6  6  1  1  1  6  6  1  6 23 27 21 21 21 31 31 21 21 21 21 21 22  6 20 21 21 29 19  6  6 20 21 21 21 21 21 21 21 21 21 21
  21 22  7  5 20 21 21 21 21 21 22  6  1 35 36 37  6  1 16  6 20 21 21 21 21 21 21 21 21 21 22  6  1  6  6  1  1  6  6  6  6  6  6  1  1  6 16  6  6 20 21 21 21 21 31 21 21 21 21 21 22  6 23 27 21 21 29 19  6 20 21 21 21 21 26 24 27 21 21 21
  21 22 14 15 20 21 21 21 21 21 22  1  6 35 36 37  1  1  6 17 30 21 21 21 21 21 21 21 21 21 22  6  6  6  1  1  6  6 32 33 33 34  6  6  1  1  6  6  6 20 21 21 21 21 31 21 21 21 21 21 22 16  6 20 21 21 21 22  6 20 21 21 21 21 22  1 20 21 21 21
  21 29 19  1 20 21 21 21 21 21 22 16  1 35 36 44 34  6  6 20 21 21 21 21 21 21 21 21 21 21 22  6  6  6  1  1  6 32 45 36 36 44 34  6  1  1  6  1  6 20 21 21 21 21 21 21 21 21 21 21 29 19  6 20 21 21 21 22  6 20 21 21 21 31 29 18 30 21 21 21
  21 21 29 19 20 21 21 21 21 21 22  1  1 35 36 41 40  6  1 20 21 21 21 21 21 31 21 21 21 21 22  6  6  6  1  6  6 35 36 46 36 36 37  6  6  1  6  6  6 20 21 21 21 21 21 21 21 21 21 21 21 22  6 23 27 21 21 22  6 23 27 21 21 21 31 31 31 21 21 21
  21 31 21 29 30 21 21 21 21 21 22  1  6 35 36 37  1  1  6 20 21 21 21 21 31 31 21 21 21 21 22  1  6 16  1  6  6 35 36 36 36 36 37  6  6  1  6  6  1 20 21 21 21 21 21 21 21 21 21 21 21 22  6  6 20 21 21 22  6  6 20 21 21 21 21 21 21 21 21 21
  21 21 31 31 21 21 21 21 21 21 22  1  1 35 36 37  1 16  6 20 21 21 21 21 31 21 21 21 21 21 22  6  6  6  1  1  6 38 42 36 36 41 40  6  1  1  6  6  6 20 21 21 21 21 21 21 21 21 21 21 21 29 19  6 23 27 21 29 19  6 20 21 21 21 21 21 21 21 21 21
  21 21 21 21 21 21 21 21 21 26 25  1  6 35 36 37  6  1  1 20 21 21 21 21 31 21 21 21 21 21 22  6  6  6  1  1 16  6 38 39 39 40  6  6  1  1  6  6  6 20 21 21 21 21 21 21 21 21 21 21 21 21 22  6  6 23 27 21 22  6 20 21 21 21 21 21 21 21 21 21
  21 21 21 21 21 21 21 21 26 25  6  6  6 38 39 40  6  6  6 20 21 21 21 21 21 31 21 21 21 21 22  6  1  6  6  1  1  6  6  6  6  6  6  1  1  6 16  1  6 20 21 21 21 21 21 21 21 21 21 21 21 21 22  1  6 16 23 24 25  6 20 21 21 21 21 21 21 21 21 21
  21 21 21 21 21 21 21 21 22 13  6  6  2  3  3  3  3  4  6 20 21 21 21 21 21 21 21 21 21 21 29 19  6  6  6  6  1  1  1  6  6  1  1  1  6  6  6  6 17 30 21 21 21 21 21 21 21 21 21 21 21 26 25  6  6  1  6  6  6  6 20 21 21 21 21 21 21 21 21 21
  21 21 21 21 21 21 21 21 29 18 19  6  5 16  6 16  6  7  6 20 21 21 21 21 21 21 21 21 21 21 21 22  1  6  6  6  6  1  1  6  6  1  1  6  6  1  6  6 20 21 21 21 21 21 21 31 31 21 21 21 21 22  6  1  6  6  6  6  1 17 30 21 21 21 21 21 21 21 21 21
  21 21 21 21 21 21 21 21 21 21 22  1  8  9  9  9  9 10  6 20 21 21 21 21 21 21 21 21 21 21 21 29 19  6  6  1 16  6  6  6  6  6 16  6  6 16  6 17 30 21 21 21 21 21 21 21 21 21 21 21 21 22  6 16  6  6  6  6 16 20 21 21 21 21 21 21 21 21 21 21
  21 28 21 28 21 21 21 21 21 21 22  1  6 32 33 34  6 16  6 20 21 21 21 21 21 21 21 21 21 21 21 21 29 19  6  6  6  1  6  6  6  6  6  1  6  6 17 30 21 21 21 21 21 21 21 21 21 21 21 21 26 25 32 33 33 33 33 34  6 20 21 21 21 21 21 21 21 21 21 21
  21 21 21 28 28 28 21 21 21 21 22  6  1 35 36 37  6  1  1 23 24 27 21 21 21 21 21 21 21 21 21 21 21 29 18 19  6  6  6  6  6  6  6  6 17 18 30 21 21 21 21 21 21 21 21 21 21 21 21 21 22  1 35 36 36 36 36 37  6 20 21 21 21 21 21 21 21 21 21 21
  21 21 21 21 21 21 21 21 21 21 22  1  6 35 36 37  1  6  1  6  1 23 27 21 21 21 21 31 31 21 21 21 21 21 21 29 18 18  6  6  6  6 18 18 30 21 21 21 21 21 21 21 21 21 21 21 21 21 21 21 22  1 35 36 43 36 36 37  6 20 21 21 21 28 21 21 21 28 21 21
  21 21 21 21 21 21 21 21 21 21 22  1  1 35 36 44 34  1  6  1 17 18 30 21 21 21 21 21 31 21 21 21 21 21 21 21 21 21 69 70 70 71 21 21 21 21 21 21 21 21 21 21 21 21 21 21 21 21 21 21 22  1 35 36 36 36 36 37  6 20 21 21 21 21 21 21 28 28 21 21
  21 21 21 21 21 21 21 21 21 21 22  6  1 35 36 36 37  6  1  6 20 21 21 21 21 21 21 21 31 31 21 21 21 21 21 21 21 21 72 73 73 74 21 21 21 21 21 21 21 31 21 21 21 26 24 27 21 21 21 26 25  1 35 36 36 36 46 37  6 20 21 21 21 21 21 21 21 28 28 21
  21 21 21 21 21 21 21 21 21 21 22  6  1 38 42 36 37  6  6  1 20 21 21 21 21 21 21 21 21 31 21 21 21 21 21 21 21 21 72 73 73 74 21 21 21 21 21 21 21 31 31 21 21 22 13 20 21 21 21 22  6  1 35 36 36 36 36 37  6 20 21 21 21 21 21 21 21 21 21 21
  21 27 21 21 21 21 21 21 21 21 22  1  1  1 35 36 44 33 34  6 23 24 27 21 21 21 21 21 21 21 21 21 21 21 21 21 21 21 72 73 73 74 21 21 21 21 21 21 31 31 21 21 21 22  6 23 24 27 26 25  6  1 35 41 39 39 39 40 17 30 21 21 21 21 21 21 21 21 21 21
  22 21 21 21 21 21 21 21 21 21 22  1 16  1 35 36 36 36 44 33 34  6 20 21 21 21 21 21 21 21 21 21 21 31 21 21 21 21 72 73 73 74 21 21 21 21 21 21 21 21 21 21 26 25  6 16  6 23 25  1  1  1 35 37  1 16  1  1 20 21 21 21 21 21 21 21 21 21 21 21
  21 21 21 21 21 21 21 21 21 21 22  6  1  1 35 36 41 39 39 39 40  6 23 27 21 21 21 21 21 21 21 21 21 21 21 21 21 21 75 76 76 77 21 21 21 21 21 21 21 21 21 21 22  1  1  6  6 11  9  9  9 12 35 37  1  1  6  6 20 21 21 21 21 21 21 21 21 21 21 21
  21 21 21 21 21 21 21 21 21 21 22  6  1  6 35 36 37 16 17 18 19  6  6 23 24 27 21 21 21 21 21 21 21 21 21 21 21 26  6  6 16  6 24 27 21 21 21 21 21 21 21 21 22  1  1 32 34  7  1  1  1  5 35 37  1  6  1  1 20 21 21 21 21 21 21 21 21 21 21 21
  21 21 21 21 21 21 21 21 21 21 22  6  6  1 35 36 37  6 20 21 29 19  6  6  6 20 21 21 21 21 21 21 21 21 21 21 21 22  6  6  6  6  6 20 21 21 21 21 21 21 21 21 22  1  1 35 37  7  6  1  6  5 35 37  1  6  1  6 20 21 21 21 21 21 21 21 21 21 21 21
  21 21 21 21 21 21 21 21 21 21 29 18 19  1 35 36 37  6 20 21 21 22  6 16  6 23 24 24 27 21 21 21 21 21 21 21 26 25  6 32 33 34  6 23 27 21 21 21 21 21 21 21 22  1  1 35 37  7  1 16  1  5 35 37  1  1  1  1 20 21 21 21 21 21 21 21 21 21 21 21
  21 21 21 21 21 21 21 21 21 21 21 21 22  1 35 36 37  6 20 21 21 29 19  6  6  6  6  6 23 27 21 21 21 26 24 24 25  6 32 45 36 44 34  6 23 24 24 27 21 26 24 24 25  1  1 35 37  7  1  6  1  5 35 44 33 33 33 34 23 27 21 21 21 21 21 21 21 21 21 21
  21 21 21 21 21 21 21 21 21 21 21 21 22  6 35 36 37  6 20 21 21 21 29 18 19  6  6  6  6 23 24 24 24 25  6  6  6 32 45 36 36 36 44 34  6  6  6 23 24 25 32 33 33 34  1 35 37 14  3  3  3 15 35 41 39 39 39 40 13 20 21 21 21 21 21 21 21 21 21 21
  21 21 21 21 21 21 21 21 21 21 21 21 22  6 35 36 37  6 20 21 21 21 21 21 22  6  6  6  6  6  6  6  6  6  6  6  6 35 36 36 36 36 36 37  6  6  6  6  1 32 45 41 42 37  1 35 44 33 33 33 33 33 45 37  6  6 17 18 18 30 21 21 21 21 21 21 21 21 21 21
  21 21 21 21 21 21 21 21 21 21 21 21 22  6 35 36 37  6 20 21 31 21 21 21 22  6  6  6  6 32 33 33 33 33 34  6  6 35 36 36 43 36 36 37  6 16  6  6  1 35 41 40 35 37  1 38 39 39 39 42 41 39 39 40 17 18 30 21 21 21 21 21 21 26 24 24 24 24 24 27
  21 21 21 21 21 28 21 21 21 21 21 26 25 32 45 36 37  6 20 21 21 21 31 21 22  6 16  6  6 35 36 46 36 36 44 33 33 45 36 36 36 36 36 37  6  6  6  6  1 35 37  1 35 37  1  1  1  1  1 35 37 17 18 18 30 21 21 21 21 21 21 21 21 22 11  9  9  9 12 20
  21 21 21 21 21 21 21 21 21 21 21 22  6 35 36 36 37  6 20 21 21 21 21 21 22  6  6  6  6 38 39 39 42 36 36 36 36 36 36 36 36 36 36 37  6  6  6 16  1 35 37  1 35 37  1  6  1 16  1 35 37 20 21 21 21 21 21 21 21 21 21 21 21 22 14  4  1  2 15 20
  21 21 28 21 21 21 21 21 21 21 21 22 32 45 36 41 40  6 23 24 24 24 24 24 25  6  6  6  6  6  6  6 35 36 36 36 46 36 36 36 36 36 36 44 34  6  6  6  1 35 37  1 35 37  1  1  1  1  1 35 37 20 21 21 21 21 21 21 21 21 21 21 21 29 19 14  3 15 17 30
  21 21 28 28 21 21 21 21 21 21 26 25 35 36 41 40  6 16  6  6  6  6  6  6  6  6  6 16  6  6  6  6 38 42 36 36 36 41 39 39 42 36 43 36 44 34  6 16  1 35 37  1 35 37 32 33 33 33 33 45 37 20 21 21 21 21 21 21 21 21 21 21 21 21 29 18 18 18 30 21
  21 21 28 28 21 21 21 21 21 21 22  6 38 39 40  6  6  6 17 18 18 18 18 19  6  6  6  6  6 16  6  6  6 38 39 39 39 40  6  6 38 39 39 42 36 37  6  6 32 45 37  1 35 37 35 41 39 39 39 39 40 20 21 21 21 21 21 21 21 21 21 21 21 31 31 21 21 21 21 21
  21 21 21 28 28 21 21 21 21 26 25  6  6  6  6 17 18 18 30 21 21 21 21 29 18 18 19  6  6  6  6  6  6  6  6 16  6  6  6  6 16  6  6 38 39 40  6  6 38 39 40  1 35 37 35 37  1  1 17 18 18 30 21 21 21 21 21 21 21 21 21 21 21 21 31 31 31 21 21 21
  21 21 21 21 21 21 21 21 26 25 13  6 17 18 18 30 21 21 21 21 21 21 21 21 21 21 29 19  6  6  6 16  6 17 18 18 18 18 18 18 18 18 18 18 18 18 18 18 18 18 19  1 35 44 45 37 17 18 30 21 21 21 21 21 21 21 21 21 21 21 21 21 21 21 21 21 21 21 21 21
  21 21 21 21 21 21 21 21 29 18 18 18 30 21 21 21 21 21 21 21 21 21 21 21 21 21 21 29 19  6  6 17 18 30 21 21 21 21 21 21 21 21 21 21 21 21 21 21 21 21 22  1 38 39 39 40 20 21 21 21 21 21 21 21 21 21 21 21 21 21 21 21 21 21 21 21 21 21 21 21
  21 21 21 21 21 21 21 21 21 21 21 21 21 21 21 21 21 21 21 21 21 21 21 21 21 21 21 21 22 17 18 30 21 21 21 21 21 21 21 21 21 21 21 21 21 21 21 21 21 21 22  1  1  1  1 17 30 21 21 21 21 21 21 21 21 21 21 21 21 21 21 21 21 21 21 21 21 21 21 21
  21 21 21 21 21 21 21 21 21 21 21 21 21 21 21 21 21 21 21 21 21 21 21 21 21 21 21 21 22 20 21 21 21 21 21 21 21 21 21 21 21 21 21 21 21 21 21 21 21 21 29 19  1  1 17 30 21 21 21 21 21 21 21 21 21 21 21 21 21 21 21 21 21 21 21 21 21 21 21 21
  21 21 21 21 21 21 21 21 21 21 21 21 31 31 31 31 31 21 21 21 21 21 21 21 21 21 21 21 29 30 21 21 21 21 21 21 21 21 21 21 21 21 21 21 31 31 21 21 21 21 21 29 18 18 30 21 21 21 21 21 21 21 21 21 21 21 21 21 21 21 21 21 21 21 28 28 21 21 21 21
  21 26 27 21 21 21 21 21 21 21 21 31 26 24 24 24 24 27 21 21 21 21 21 21 21 21 21 21 21 21 21 21 21 21 21 21 21 21 21 21 21 21 21 21 21 31 21 21 21 21 21 21 21 21 21 21 21 21 21 21 21 21 21 21 21 31 31 21 21 21 21 21 21 21 21 28 28 21 21 21
  21 22 20 31 21 21 21 21 21 21 21 26 25 11  9  9 12 23 27 21 21 21 21 21 21 21 21 21 21 21 21 21 21 21 21 21 21 21 21 26 27 21 21 21 21 21 21 21 21 21 21 21 21 21 21 21 21 21 21 21 21 21 21 21 31 21 21 31 31 21 21 21 21 21 21 21 28 21 21 21
  21 22 20 31 21 21 21 21 21 21 21 22  1  7  1  1  8 12 20 21 21 21 21 21 21 21 21 28 21 21 21 21 21 21 21 21 21 31 21 22 20 21 21 21 21 21 21 21 21 21 21 21 28 21 21 21 21 21 21 21 21 21 21 21 26 24 24 24 24 24 24 24 27 21 21 21 21 21 21 21
  21 29 30 31 21 21 21 21 21 21 21 29 19 14  3  3  3 15 20 21 31 21 21 21 21 21 28 28 28 21 21 21 21 21 21 21 31 21 21 29 30 21 21 21 21 21 21 21 21 21 21 21 28 28 28 21 21 21 21 21 21 21 21 31 22  1  1  6  6  6  1  6 20 21 21 21 21 21 21 21
  21 21 21 31 21 21 21 21 21 21 21 21 29 18 18 19 17 18 30 21 21 21 21 21 21 21 21 28 28 28 21 21 21 21 21 21 21 21 21 21 21 21 21 21 21 21 21 21 21 21 21 21 21 21 21 21 21 21 21 21 21 21 21 21 29 18 18 18 18 18 18 18 30 21 21 21 21 21 21 21
  21 21 21 21 21 21 21 21 21 21 21 21 21 21 21 29 30 21 21 21 21 21 21 21 21 21 21 21 21 21 21 21 21 21 21 21 21 21 21 21 21 21 21 21 21 21 21 21 21 21 21 21 21 21 21 21 21 21 21 21 21 21 21 21 21 21 21 21 21 21 21 21 21 21 21 21 21 21 21 21
